5
5
11111
10111
11011
11011
11111
