8
8
11145000
11541500
11111151
21111111
11111111
11511151
11141500
11145000
