7
7
1101011
2100011
1011114
1111551
1111551
1111551
1111111
