9
9
111155551
111111011
211111011
111111011
111111111
115111141
115111141
115111141
115111141
