10
10
1111111411
4441411441
1141451111
1341411111
1041411444
1141411112
1441411111
1151411444
1111411111
1151111111
