10
5
1111101111
1101111111
0100111011
1011111011
1111111111