5
5
11111
12111
11101
11001
11111
