10
5
5551411111
2101411011
5111411111
1101411011
1111411111
