5
7
11111
21111
11311
11111
10001
11411
11511
