12
9
111111111111
111111111012
111311011111
111111011111
111111011111
111311111111
111111100011
110111111100
110111111111