9
9
111111011
111111101
211110101
111111111
111110111
111111001
111111111
111444411
111111111
