10
10
1111141111
1211111111
1111140111
1151111111
1111140111
1111111111
1111141111
1511141113
1151111511
1111141111
