5
7
21111
11131
10011
10011
11111
11141
11115
