9
9
111004111
111004511
115114511
111111511
211111111
111111111
115114511
111004511
111004511
