10
10
1111111111
1111411111
1111411011
2111411111
1111110131
1111401111
1151411111
1111115111
1151111111
1111111111
