8
8
11111000
11111110
11111111
21111111
11114441
11411111
11411110
11411000
