10
5
2111111111
1111111111
1111001111
1111111111
1111111111