5
5
11111
10111
11001
11101
11111
