12
9
111111111111
111111111012
111311411111
111111411111
111111411111
111311111111
111111144411
110111111100
110111111111