10
10
1111111111
1111111011
1111110011
1111011111
1111110111
1111101111
1111111111
1111111111
1111111111
1111111111
