10
10
1111101010
1101110111
1010101010
1101101001
1001110001
1100011101
0100100010
1010000001
1100101010
1111011101
