12
12
111111111111
111111111111
111101111111
111000111111
111000111111
111000111111
111000111111
111000111111
111011011111
111111111111
111111111111
111111111111
