12
12
111111111111
111111111111
111110111111
111010111111
111111111111
111111011111
110101111111
111011011111
111111111111
111111111111
111111111111
111111111111
