9
9
111011111
101011001
101010011
100010111
111111111
111001011
111111110
111111111
111111111
